1111111111111
1P0010C00E011
1000011011101
10001100C0001
1111111111111
