1111111111111
1P000C0C00011
111100E011101
10C00110C0001
1111111111111
