1111111111111
1P000C0C00011
1000011011101
10001100C00E1
1111111111111
