1111111111111
1P001000000C1
10000P1011101
1000110000001
1111111111111
