1111111111111
1P000C0C00011
1010011011101
1CE00110C0001
1111111111111

